,SB,CR,PR,PD,SUM,LB
<<<<<<< Updated upstream
0,7,5,3,6,14,Ongoing
1,24,5,15,3,23,Died
2,11,15,18,2,35,Ongoing
3,10,3,3,29,35,Ongoing
4,29,23,2,11,36,Died
5,1,8,2,27,37,Ongoing
6,20,5,27,5,37,Died
7,16,1,13,23,37,Died
8,25,1,14,25,40,Died
9,18,25,4,11,40,Ongoing
10,17,25,8,7,40,Ongoing
11,14,17,16,8,41,Died
12,4,19,3,19,41,Died
13,26,21,17,4,42,Ongoing
14,5,29,4,11,44,Died
15,15,16,6,23,45,Ongoing
16,22,8,24,13,45,Died
17,19,18,27,1,46,Died
18,6,20,17,11,48,Died
19,23,23,19,7,49,Died
20,27,18,23,13,54,Ongoing
21,13,25,11,21,57,Died
22,28,29,18,11,58,Ongoing
23,8,27,5,28,60,Ongoing
24,3,22,24,15,61,Died
25,9,9,25,28,62,Ongoing
26,12,7,27,29,63,Ongoing
27,2,26,15,26,67,Ongoing
28,0,26,22,19,67,Died
29,21,29,25,29,83,Ongoing
=======
0,9,3,12,2,17,Ongoing
1,6,5,12,4,21,Ongoing
2,15,8,11,3,22,Died
3,29,9,3,11,23,Ongoing
4,22,7,6,12,25,Died
5,10,3,21,1,25,Ongoing
6,25,1,1,26,28,Ongoing
7,4,7,7,18,32,Ongoing
8,26,8,22,3,33,Died
9,19,5,18,14,37,Died
10,14,23,9,5,37,Ongoing
11,18,2,7,29,38,Died
12,2,18,19,2,39,Ongoing
13,28,19,11,10,40,Died
14,20,8,27,8,43,Died
15,27,13,17,13,43,Ongoing
16,12,14,2,28,44,Ongoing
17,21,10,27,7,44,Died
18,3,15,27,2,44,Ongoing
19,5,12,13,21,46,Ongoing
20,17,25,20,2,47,Ongoing
21,24,13,20,14,47,Ongoing
22,13,11,27,11,49,Died
23,16,22,17,11,50,Died
24,23,5,20,25,50,Died
25,11,24,12,18,54,Died
26,7,20,9,27,56,Died
27,8,19,17,21,57,Died
28,0,28,10,22,60,Died
29,1,29,20,25,74,Ongoing
>>>>>>> Stashed changes
