,SB,CR,PR,PD,SUM,LB
0,4,14,1,4,19,Ongoing
1,9,18,4,2,24,Died
2,0,13,6,7,26,Died
3,19,20,7,2,29,Ongoing
4,18,23,3,3,29,Ongoing
5,14,1,20,10,31,Died
6,10,25,7,4,36,Died
7,16,15,9,13,37,Died
8,20,3,13,22,38,Ongoing
9,25,3,9,27,39,Died
10,11,24,13,2,39,Ongoing
11,27,3,16,22,41,Died
12,28,1,26,15,42,Ongoing
13,17,9,21,12,42,Died
14,23,23,1,19,43,Died
15,2,2,22,21,45,Ongoing
16,21,19,14,12,45,Died
17,24,23,9,13,45,Died
18,22,12,13,21,46,Ongoing
19,12,12,24,12,48,Ongoing
20,5,3,25,26,54,Died
21,1,23,19,15,57,Died
22,8,29,17,11,57,Ongoing
23,3,9,21,28,58,Ongoing
24,7,27,8,26,61,Ongoing
25,13,21,18,23,62,Ongoing
26,26,23,24,16,63,Ongoing
27,15,27,13,27,67,Ongoing
28,6,22,19,27,68,Died
29,29,23,28,25,76,Died
